1111111111111
1X0100C000XC1
10X0001101001
1P0011EC000X1
1111111111111
