11111111111111111111111111
1E0000000000000C00000CX111
10100101X01000001010010001
1010X100101010100010010001
1P0000000C00C00000000000X1
11111111111111111111111111
