111111111111111111111111111111111111111111111111111111111
1P000000000001111111C0000000111100C00000000000000000000C1
1111110000000000C111111111000000000000000C000000000001111
100000000001111111111100000000101010101000000000000000111
111110000000000011111111000000000000000000111101110000001
1000000000000000000000C0000000000000000000000000000000001
10000000000001111111000000001111000000000C00000000C000001
1111110000000000C1111111110000000000000000000000000001111
1C00000000011111111111000000001C1C1C1C1000000000000000111
111110000000000011111111000000000000000000111101110000001
100000000000000000000000000000000000000000000000000000001
100000000000C11111110000000011110000000000000000000000001
111111000000000001111111110000000000000000000000000001111
1C0000000001111111111100000000101010101000000000000000111
111110000000000011111111000000000000000000111101110000001
100000000000000000000000000000000000000000000000000000001
100000000000C11111110000000011110000000000000000000000001
111111000000000001111111110000000000000000000000000001111
1C0000000001111111111100000000101010101000000000000000111
111100000000000111111110000000000000000001111011100000011
1000000000C000000000C000000000C0000000C0000000000000000E1
111111111111111111111111111111111111111111111111111111111
