11111111111111111111111111
1E0000000000000C00000C0001
1P0000000C00C0000000000011
111111111111111111111111C1
11111111111111111111111111