1111111111111111111111111
101111E0000000000111110C1
111C01111111111000C000001
1C0010000000C0000C0000001
1010001111111111111111111
10000000C0000000C000000C1
1111111111111111111100111
1P00C0000C000C00000C00001
1111111111111111111111111
