001111111100
010000000C11
0101C1000010
01C110P11110
01011C001110
0101EC100C10
011111111100
000000000000