11111111
100P0001
10000001
10C003E1
11111111
